A Companion to Digital Art 	 776  	 Arts & recreation/Photography & computer art/Computer art (Digital art)/A Companion To Digital Art - Christiane Paul
Computer Graphics from Scratch A Programmers Introduction to 3D Rendering - Gabriel Gambetta 	 006.6  	 Computer science, information & general works/Computer science, knowledge & systems/Special computer methods/Computer Graphics From Scratch_ A Programmer'S Introduction To 3D Rendering - Gabriel Gambetta
GLSL Essentials 	 794.81526  	 Arts & recreation/Sports, games & entertainment/Indoor games of skill/GLSL Essentials_ Enrich Your 3D Scenes With The Power Of GLSL! - Jacobo Rodriguez
Grokking Algorithms 	 005.1  	 Computer science, information & general works/Computer science, knowledge & systems/Computer programming, programs & data/Grokking Algorithms_ An Illustrated Guide For Programmers And Other Curious People - Aditya Y. Bhargava
Interaction of Color 	 701.85  	 Arts & recreation/Arts/Philosophy of fine & decorative arts/Interaction Of Color - Yale University Press [Publisher], Josef Albers
Interactive Computer Graphics 	 006.66  	 Computer science, information & general works/Computer science, knowledge & systems/Special computer methods/Interactive Computer Graphics_ A Top-Down Approach With OpenGL - Edward Angel
Jim Blinn's Corner - Notation, Notation, Notation 	 006.686  	 Computer science, information & general works/Computer science, knowledge & systems/Special computer methods/Jim Blinn'S Corner_ Notation, Notation, Notation - Jim Blinn
Learning Processing. A Beginners Guide to Programming Images, Animation, and Interaction (Morgan Kaufmann Series) - Daniel Shiffman 	 006.76  	 Computer science, information & general works/Computer science, knowledge & systems/Special computer methods/Learning Processing_ A Beginner'S Guide To Programming Images, Animation, And Interaction - Daniel Shiffman
Making Music with Computers 	 781.345133  	 Arts & recreation/Music/General principles & musical forms/Making Music With Computers_ Creative Programming In Python - Andrew R. Brown, Bill Manaris
Point-based graphics 	 006.6  	 Computer science, information & general works/Computer science, knowledge & systems/Special computer methods/Point-Based Graphics - Markus Gross, Hanspeter Pfister
Processing - A Programming Handbook for Visual Designers and Artists 	 005.1  	 Computer science, information & general works/Computer science, knowledge & systems/Computer programming, programs & data/Processing_ A Programming Handbook For Visual Designers And Artists - Ben Fry, Casey Reas
Processing - Creative Coding and Generative Art in Processing - Ira Greenberg, Dianna Xu, Deepak Kumar 	 776  	 Arts & recreation/Photography & computer art/Computer art (Digital art)/Processing_ Creative Coding And Generative Art In Processing 2 - Ira Greenberg, D. Kumar, Dianna Xu
Texturing and Modeling, A Procedural Approach 	 005.1  	 Computer science, information & general works/Computer science, knowledge & systems/Computer programming, programs & data/Texturing And Modeling_ A Procedural Approach - F. Kenton Musgrave, David S. Ebert, Darwyn Peachey
The Laws of Simplicity 	 650.1  	 Technology/Management & public relations/Management & auxiliary services/The Laws Of Simplicity - John Maeda
Visualization in Medicine -Theory, Algorithms, and Applications 	 616.0754  	 Technology/Medicine & health/Diseases/Visualization In Medicine_ Theory, Algorithms, And Applications - Bernhard Preim, D. Bartz
OpenGL 4.0 Shading Language Cookbook 	 005.133  	 Computer science, information & general works/Computer science, knowledge & systems/Computer programming, programs & data/OpenGL 4.0 Shading Language Cookbook_ Over 60 Highly Focused, Practical Recipes To Maximize Your Use Of The OpenGL Shading Language - David WolffGeometry of Design 	 701.8  	 Arts & recreation/Arts/Philosophy of fine & decorative arts/Geometry Of Design_ Studies In Proportion And Composition - Kimberly Elam
Islamic Design - A Mathematical Approach 	 704.94897  	 Arts & recreation/Arts/Special topics in fine & decorative arts/Islamic Design_ A Mathematical Approach - David Wade, Brian A. Wichmann
Islamic geometric patterns, their historical development and traditional methods of construction 	 701  	 Arts & recreation/Arts/Philosophy of fine & decorative arts/Islamic Geometric Patterns_ Their Historical Development And Traditional Methods Of Construction - Roger Penrose, Jay Bonner, Craig Kaplan
Symetries 	 530.1  	 Science/Physics/Physics/Fearful Symmetry_ The Search For Beauty In Modern Physics - Roger Penrose, A. Zee
Viewpoints 	 742.0151  	 Arts & recreation/Drawing & decorative arts/Perspective/Viewpoints_ Mathematical Perspective And Fractal Geometry In Art - Annalisa Crannell, Marc Frantz
Connections 	 823.8  	 Literature/English & Old English literatures/English fiction/Wuthering Heights - Ian Jack, Pauline Nestor, Emily Bronte, Patsy Stoneman
The Analytic Art 	 512  	 Science/Mathematics/Algebra/The Analytic Art_ Nine Studies In Algebra, Geometry, And Trigonometry From The Opus Restitutae Mathematicae Analyseos, Seu, Algebrâ Novâ - François Viète
Aboriginal 	 971.200497  	 History & geography/History of North America/Canada/Clearing The Plains_ Disease, Politics Of Starvation, And The Loss Of Aboriginal Life - James W. Daschuk1961-  (James William)
Advanced Data Structures 	 005.1  	 Computer science, information & general works/Computer science, knowledge & systems/Computer programming, programs & data/Advanced Data Structures - Peter Brass
A File Comparison Program 	 510.785  	 Science/Mathematics/Mathematics/A File Comparison Program - Webb Miller
A Gateway To Sindarin 	 499.99  	 Language/Other languages/Austronesian & other languages/A Gateway To Sindarin_ A Grammar Of An Elvish Language From J.R.R. Tolkien'S Lord Of The Rings - David Salo
A History of the English Language 	 420.9  	 Language/English & Old English languages/English & Old English/A History Of The English Language - Yongliang Pan, Albert C. Baugh1891-1981  (Albert Croll), Thomas Cable
Algorithms and theory of computation handbook 	 511.3  	 Science/Mathematics/General principles of mathematics/Algorithms And Theory Of Computation Handbook - Mikhail J. Atallah, Marina Blanton
Algorithms for Programmers 	 005.133  	 Computer science, information & general works/Computer science, knowledge & systems/Computer programming, programs & data/Practical Algorithms For Programmers - Andrew Binstock, John Rex
Al-Kitaab fii Taallum al-Arabiyya Part 1 	 492.782421 : Language/Other languages/Afro-Asiatic languages; Semitic languages/Al-Kitaab Fii Taʻallum Al-ʻArabiyya =_ A Textbook For Beginning Arabic  	 Part One - Kristen Brustad
A Mathematical Theory of Communication 	 621.381  	 Technology/Engineering/Applied physics/The Mathematical Theory Of Communication - Claude Elwood Shannon, Warren Weaver
A Nahuatl-English Dictionary 	 897.4  	 Literature/Other literatures/North American native literatures/A Nahuatl-English Dictionary And Concordance To The Cantares Mexicanos_ With An Analytic Transcription And Grammatical Notes - John Bierhorst
Analysing sentences 	 425  	 Language/English & Old English languages/English grammar/Analysing Sentences_ An Introduction To English Syntax - Noel Burton-Roberts
An Introduction to English Phonology 	 421.5  	 Language/English & Old English languages/English writing system & phonology/An Introduction To English Phonology - April M. S. McMahon
An Introduction to Sociolinguistics 	 306.44  	 Social sciences/Social sciences, sociology & anthropology/Culture & institutions/An Introduction To Sociolinguistics - Ronald Wardhaugh, Janet M. Fuller
Anishinaabemowin 	 897.333  	 Literature/Other literatures/North American native literatures/Weweni_ Poems In Anishinaabemowin And English By Margaret Noodin - Margaret Noodin
arabic calligraphy 	 745.619927  	 Arts & recreation/Drawing & decorative arts/Decorative arts/The Art Of Arabic Calligraphy - Yousif Mahmud Ghulam
Arabic-Handwriting 	 492.7834  	 Language/Other languages/Afro-Asiatic languages; Semitic languages/Gateway To Arabic_ Book 6 - Imran Hamza Alawiye
Arabic-Hippocrene 	 492.73  	 Language/Other languages/Afro-Asiatic languages; Semitic languages/Arabic-English English-Arabic_ Hippocrene Standard Dictionary - John Wortabet
Arabic-Script 	 492.711096  	 Language/Other languages/Afro-Asiatic languages; Semitic languages/The Arabic Script In Africa_ Studies In The Use Of A Writing System - Kees Versteegh, Meikal Mumin
Arabiyyat Al-Naas Part One 	 492.782421  	 Language/Other languages/Afro-Asiatic languages; Semitic languages/Arabiyyat Al-Naas_ Part One - Hanada Al-Masri, Munther Abdullatif Younes
Arabiyyat Al-Naas Part Two 	 492.782421  	 Language/Other languages/Afro-Asiatic languages; Semitic languages/Arabiyyat Al-Naas_ Part One - Hanada Al-Masri, Munther Abdullatif Younes
Arrernte 	 305.899915  	 Social sciences/Social sciences, sociology & anthropology/Social groups/Arrernte Present, Arrernte Past_ Invasion, Violence, And Imagination In Indigenous Central Australia - Diane J. Austin-Broos
ASL-demystified 	 419.7  	 Language/Linguistics/Sign languages/American Sign Language Demystified - Kristin J. Mulrooney
ASL-dictionary 	 419.7  	 Language/Linguistics/Sign languages/Basic ASL Dictionary - Franklin Byrom
Australian Sign Language (Auslan)_ An introduction to sign language linguistics 	 419.94  	 Language/Linguistics/Sign languages/Australian Sign Language (Auslan)_ An Introduction To Sign Language Linguistics - Trevor A. Johnston, Adam Schembri
Authority 	 223.2  	 Religion/The Bible/Poetic books of Old Testament/The Psalms Of David In Meeter - Church of Scotland. [Other], Church of Scotland [Other]
Babylonian-TY 	 492.182421  	 Language/Other languages/Afro-Asiatic languages; Semitic languages/Complete Babylonian - Martin Worthington
Bangla Academy English-Bengali Dictionary 	 423.9144  	 Language/English & Old English languages/English dictionaries/Bangla Academy English-Bengali Dictionary - Bāṃlā Ekāḍemī (Bangladesh), Jahangir Tareque, Jillura Rahamāna Siddikī, Zillur Rahman Siddiqui
BSL 	 419.41  	 Language/Linguistics/Sign languages/British Sign Language For Dummies - England) City Lit Centre for the Deaf (London
Cebuano for Beginners 	 499.21  	 Language/Other languages/Austronesian & other languages/Cebuano For Beginners, - Elsa Paula Yap
Cheat Sheet 	 006.6869  	 Computer science, information & general works/Computer science, knowledge & systems/Special computer methods/Microsoft PowerPoint 2000 MOUS Cheat Sheet - Doug Klippert
Coast Tsimshian Language) 	 497.4  	 Language/Other languages/North American native languages/A Practical Dictionary Of The Coast Tsimshian Language - John Asher Dunn
Concise English-Tigrinya dictionary 	 423.928  	 Language/English & Old English languages/English dictionaries/Concise English-Tigrinya Dictionary - Tuquabo Aressi
Coreano básico 	 495.73461  	 Language/Other languages/Languages of East & Southeast Asia/El Coreano Basico - In-sug Bag
Corpus Linguistics 	 410.285  	 Language/Linguistics/Linguistics/Corpus Linguistics And The Description Of English - Magnus Levin, Hans Lindquist
Diccionario chontal de Tabasco 	 497.415  	 Language/Other languages/North American native languages/Diccionario Chontal De Tabasco - Kathryn C. Keller, Plácido Luciano G.
Discovering Albanian I Textbook 	 491.99182421  	 Language/Other languages/East Indo-European & Celtic languages/Discovering Albanian I Textbook - Héctor Campos, Linda Mëniku
Dyirbal Language of North Queensland (Dixon) 	 499.15  	 Language/Other languages/Austronesian & other languages/The Dyirbal Language Of North Queensland - Robert M. W Dixon
El Coreano Basico 	 495.73461  	 Language/Other languages/Languages of East & Southeast Asia/El Coreano Basico - In-sug Bag
epdf.pub_haitian-creole-phrasebook-essential-expressions-fo 	 447.97294  	 Language/French & related languages/French language variations/Haitian Creole Phrasebook_ Essential Expressions For Communicating In Haiti - Jowel C. Laguerre, Cécile Accilien
Ewha Korean 1-1 	 411.86 : Language/Linguistics/Writing systems/Ihwa Han'Gugŏ_ Ewha Korean,  	 3-2 =. English Version -
Farsi (Persian) for Beginners_ Mastering Conversational Farsi ( PDFDrive.com ) 	 491.55  	 Language/Other languages/East Indo-European & Celtic languages/Farsi (Persian) For Beginners_ Mastering Conversational Farsi - Saeid Atoofi, Maliheh Atoofi
Fiji-Hindi 	 491.4383421  	 Language/Other languages/East Indo-European & Celtic languages/Fiji Hindi_ A Basic Course And Reference Grammar - Rama Narayan, Rodney F. Moag
Fiji Hindi - English, English - Fiji Hindi Dictionary 	 491.437099611  	 Language/Other languages/East Indo-European & Celtic languages/Fiji Hindi-English, English-Fiji Hindi Dictionary - Susan Hobbs
Forensic-Linguistics 	 363.2522  	 Social sciences/Social problems & social services/Other social problems & services/Dimensions Of Forensic Linguistics - M. Teresa Turell, John Gibbons
French 	 823.8  	 Literature/English & Old English literatures/English fiction/Alice'S Adventures In Wonderland - John Tenniel, Helen Oxenbury, Lewis Carroll, Donald J. Gray
French-Routledge 	 332.03  	 Social sciences/Economics/Financial economics/Routledge French Dictionary Of Business, Commerce And Finance_ French - English, English - French = Routledge Dictionnaire Anglais Des Affaires, Du Commerce Et De La Finance -
Gagana Samoa_ A Samoan Language Coursebook 	 499.46282421  	 Language/Other languages/Austronesian & other languages/Gagana Sāmoa_ A Samoan Language Coursebook - Galumalemana Afeleti L. Hunkin
GENKI I_ An Integrated Course in Elementary Japanese 	 495.682421 : Language/Other languages/Languages of East & Southeast Asia/Shokyū Nihongo_ Genki : I = An Integrated Course In Elementary Japanese  	 Genki - Eri Banno
Gramática de uso del Español Teoría y práctica. Con solucionario. B1-B2 	 465 : Language/Spanish & Portuguese languages/Spanish grammar/Gramática De Uso Del Español_ Teoría Y Práctica : Con Solucionario  	 B1-B2 - Luis Aragonés
Gramática de uso del español_ Teoría y práctica_ Con solucionario. C1-C2 	 465 : Language/Spanish & Portuguese languages/Spanish grammar/Gramática De Uso Del Español_ Teoría Y Práctica : Con Solucionario  	 C1-C2 - Ramón Palencia, Luis Aragonés
Gray, Iain - Snake charming -- the musical Python-Springer (2017) 	 005.133  	 Computer science, information & general works/Computer science, knowledge & systems/Computer programming, programs & data/Snake Charming_ The Musical Python - Iain Gray
Greek-Ancient 	 264.03  	 Religion/Christian organization, social work & worship/Public worship/The Book Of Common Prayer, And Administration Of The Sacraments And Other Rites And Ceremonies Of The Church, According To The Use Of The United Church Of England And Ireland ; Together With The Psalter, Or Psalms Of David, In Eight Languages ; Namely, English, French, Italian, German, Spanish, Greek, Ancient And Modern, Latin ... [Et Al.] - Church of England
Greek-Script 	 686.218  	 Technology/Manufacture for specific uses/Printing & related activities/Aldus Manutius And The Development Of Greek Script &Amp; Type In The Fifteenth Century - Nicolas Barker
Gullah culture in America 	 975.00496073  	 History & geography/History of North America/Southeastern United States/Gullah Culture In America - Wilbur Cross
Hands-On RESTful API Design Patterns and Best Practices 	 005.3  	 Computer science, information & general works/Computer science, knowledge & systems/Computer programming, programs & data/Hands-On RESTful API Design Patterns And Best Practices_ Design, Develop, And Deploy Highly Adaptable, Scalable, And Secure RESTful Web APIs - Pethuru Raj, Harihara Subramanian
Hausa 	 787.20966  	 Arts & recreation/Music/Stringed instruments/Fiddling In West Africa_ Touching The Spirit In Fulbe, Hausa, And Dagbamba Cultures - Jacqueline Cogdell DjeDje
Hawaiian 	 996.9  	 History & geography/History of other areas/Other parts of Pacific; Polynesia/Shoal Of Time;_ A History Of The Hawaiian Islands - Gavan Daws
Hebrew-Grammar 	 492.4  	 Language/Other languages/Afro-Asiatic languages; Semitic languages/Gesenius' Hebrew Grammar, - Wilhelm Gesenius, E. 1841-1910 Kautzsch, Emil Roediger, A. E. 1861-1931 Cowley
Hebrew-Routledge 	 492.45  	 Language/Other languages/Afro-Asiatic languages; Semitic languages/Morphophonemics Of Modern Hebrew (Routledge Revivals) - Noam Chomsky
Hindi in Three months 	 491.4382421  	 Language/Other languages/East Indo-European & Celtic languages/Hindi In Three Months - Mark Allerton
HTML & CSS The Good Parts (Animal Guide) 	 006.74  	 Computer science, information & general works/Computer science, knowledge & systems/Special computer methods/HTML &Amp; CSS_ The Good Parts - Ben Henick
Icelandic 	 843.8  	 Literature/French & related literatures/French fiction/A Journey To The Centre Of The Earth - James Hynes, Lars Hokanson, Jules Verne, Robert Baldick
Igbo 	 261.096  	 Religion/Christian organization, social work & worship/Social theology/Inculturation As Dialogue_ Igbo Culture And The Message Of Christ - Chibueze C. Udeani, Inc Ebrary
Introduction.to.Computation.and.Programming.Using.Python 	 005.133  	 Computer science, information & general works/Computer science, knowledge & systems/Computer programming, programs & data/Introduction To Computation And Programming Using Python_ With Application To Understanding Data - John V. Guttag
Iontenwennaweienstahkhwa_. Mohawk Spelling Dictionary 	 497.5  	 Language/Other languages/North American native languages/Iontenwennaweienstahkhwa'_ Mohawk Spelling Dictionary - Marianne Mithun
Japanese for Busy People 	 495.683421  	 Language/Other languages/Languages of East & Southeast Asia/Japanese For Busy People II - Kokusai Nihongo Fukyū Kyōkai (Japan) [Author; Issuing body; Editor; Other]
Japanese-Genki 	 495.6  	 Language/Other languages/Languages of East & Southeast Asia/Shokyū Nihongo Genki =_ An Integrated Course In Elementary Japanese Genki - Yutaka Ōno, Eri Banno, Yōko Ikeda, Chikako Shinagawa
Java In A Nutshell A desktop quick reference by David Flanagan (z-lib.org) 	 005.133  	 Computer science, information & general works/Computer science, knowledge & systems/Computer programming, programs & data/Java In A Nutshell - Łukasz Piwko, David Flanagan, Benjamin J. Evans
Korean-Hippocrene 	 495.7  	 Language/Other languages/Languages of East & Southeast Asia/Korean_ Hippocrene Handy Dictionaries -
Kurmanji 	 398.20899159  	 Social sciences/Customs, etiquette & folklore/Folklore/Dewrêsê Evdî. A Kurmanji Epic As Performed By The Berazi Singer Baqî Xido - Barbara Sträuli Arslan
Lao Basics_ An Introduction to the Lao Language 	 495.919  	 Language/Other languages/Languages of East & Southeast Asia/Lao Basics_ An Introduction To The Lao Language - Sam Brier
(Learning about Language) Keith Johnson - The history of Early English _ An Activity-based Introduction to Early, Middle and Early Modern English language-Routledge (2016) 	 420.9  	 Language/English & Old English languages/English & Old English/The History Of Early English_ An Activity-Based Approach - Keith Johnson
Learning Perl 6 Keeping the Easy, Hard, and Impossible within Reach 	 005.133  	 Computer science, information & general works/Computer science, knowledge & systems/Computer programming, programs & data/Learning Perl 6_ Keeping The Easy, Hard, And Impossible Within Reach - Brian D. Foy
Learning PHP, MySQL, and JavaScript by Robin Nixon (z-lib.org) 	 005.2762  	 Computer science, information & general works/Computer science, knowledge & systems/Computer programming, programs & data/Learning PHP, MySQL &Amp; JavaScript_ With JQuery, CSS &Amp; HTML5 - Robin Nixon
Learn Python by building data science applications 	 005.133  	 Computer science, information & general works/Computer science, knowledge & systems/Computer programming, programs & data/Learn Python By Building Data Science Applications_ A Fun, Project-Based Guide To Learning Python 3 While Building Real-World Apps - Philipp Kats, David Katz
Learn to Read Latin Textbook 	 478.2421  	 Language/Latin & Italic languages/Classical Latin usage/Learn To Read Latin - Andrew Keller, Stephanie Russell
Linguistics _ a complete introduction 	 410  	 Language/Linguistics/Linguistics/Linguistics_ A Complete Introduction - David Hornsby
Lithuanian-Routledge 	 491.9282421  	 Language/Other languages/East Indo-European & Celtic languages/Colloquial Lithuanian_ The Complete Course For Beginners - Meilutė Ramonienė, Ian Press
Lojban 	 499.99  	 Language/Other languages/Austronesian & other languages/The Complete Lojban Language - John Woldemar Cowan
Luganda-English Dictionary 	 496.39  	 Language/Other languages/African languages/Luganda - English Dictionary; - R. A. Snoxall
Lushootseed Dictionary 	 497.9  	 Language/Other languages/North American native languages/Lushootseed Dictionary - Dawn E. Bates, Thom Hess, Vi Hilbert
Lushootseed reader with introductory grammar 	 497.9  	 Language/Other languages/North American native languages/Lushootseed Reader With Introductory Grammar - Thom Hess
Macedonian 	 491.81982421  	 Language/Other languages/East Indo-European & Celtic languages/Macedonian_ A Course For Beginning And Intermediate Students = [Makedonski Jazik] - Liljana Mitkovska, Christina Elizabeth Kramer
Mapudungun 	 498  	 Language/Other languages/South American native languages/Diccionario Araucano-Español Y Español-Araucano, - Félix José de Augusta
Morphology 	 415.9  	 Language/Linguistics/Grammar/What Is Morphology? - Kirsten Anne Fudeman, Mark Aronoff
Navajo 	 813.6  	 Literature/American literature in English/American fiction in English/Code Talker_ A Novel About The Navajo Marines Of World War Two - Joseph Bruchac
Navajo-Dictionary 	 497.2  	 Language/Other languages/North American native languages/The Navajo Dictionary On Diagnostic Terminology_ A Reference Guide On Navajo Usage Of Diagnostic Terms - Diné Center for Human Development
Ojibwe Vocabulary Project 	 497.333  	 Language/Other languages/North American native languages/Aaniin Ekidong =_ Ojibwe Vocabulary Project -
OpenGL Distilled 	 006.66  	 Computer science, information & general works/Computer science, knowledge & systems/Special computer methods/OpenGL Distilled - Paul Martz
OpenGL Shading 	 005.133  	 Computer science, information & general works/Computer science, knowledge & systems/Computer programming, programs & data/OpenGL 4.0 Shading Language Cookbook_ Over 60 Highly Focused, Practical Recipes To Maximize Your Use Of The OpenGL Shading Language - David Wolff
OpenGL SuperBible 	 006.66  	 Computer science, information & general works/Computer science, knowledge & systems/Special computer methods/OpenGL Superbible_ Comprehensive Tutorial And Reference - Nicholas Haemel, Benjamin Lipchak, Richard S. Wright
Perl One-Liners 130 Programs That Get Things Done 	 005.133  	 Computer science, information & general works/Computer science, knowledge & systems/Computer programming, programs & data/Perl One-Liners_ 130 Programs That Get Things Done - Peteris Krumins
PHP 5 Recipes 	 005.133  	 Computer science, information & general works/Computer science, knowledge & systems/Computer programming, programs & data/PHP 5 Recipes_ A Problem-Solution Approach - Lee Babin, Nathan A. Good, Jon Stephens
PHP Cookbook 	 006.76  	 Computer science, information & general works/Computer science, knowledge & systems/Special computer methods/PHP Cookbook - David Sklar, Adam Trachtenberg
Portuguese-Grammar 	 469.798  	 Language/Spanish & Portuguese languages/Portuguese/Modern Brazilian Portuguese Grammar_ A Practical Guide - John Whitlam, ProQuest (Firm)
Psycholinguistics 	 401.9  	 Language/Language/Philosophy & theory/The Articulate Mammal_ An Introduction To Psycholinguistics - Jean Aitchison, Yanping Dong
Python Data Science Handbook 	 006.312  	 Computer science, information & general works/Computer science, knowledge & systems/Special computer methods/Python Data Science Handbook_ Essential Tools For Working With Data - Jacob T. Vanderplas
Python GUI Programming Cookbook 	 005.133  	 Computer science, information & general works/Computer science, knowledge & systems/Computer programming, programs & data/Python GUI Programming Cookbook_ Over 80 Object-Oriented Recipes To Help You Create Mind-Blowing GUIs In Python - Burkhard A. Meier
Python One-Liners 	 005.133  	 Computer science, information & general works/Computer science, knowledge & systems/Computer programming, programs & data/Python One-Liners_ Write Concise, Eloquent Python Like A Professional - Dpunkt.Verlag [Publisher], Christian Mayer
Romanian-Grammar 	 459  	 Language/Italian, Romanian & related languages/Romanian & related languages/Descriptive Romanian Grammar_ An Outline - Laura Daniliuc
Sanskrit Text 	 294.385  	 Religion/Other religions/Religions of Indic origin/The Philosophy Of The Middle Way =_ Mūlamadhyamakakārikā - David J. Kalupahana, J. W. de 1921-2000 Jong, Chr. Lindtner, active 2nd century Nāgārjuna
Spanish-Advanced 	 468.3421  	 Language/Spanish & Portuguese languages/Standard Spanish usage/Communicating In Spanish. Novice/Elementary Level - Conrad J. Schmitt, Protase E. Woodford
Spanish-Grammar 	 468.2421  	 Language/Spanish & Portuguese languages/Standard Spanish usage/Schaum'S Outline Of Spanish Grammar - Conrad J. Schmitt
Sumerian 	 299.92  	 Religion/Other religions/Religions not provided for elsewhere/Sumerian Mythology;_ A Study Of Spiritual And Literary Achievement In The Third Millennium B.C - Samuel Noah Kramer
Tagalog for Beginners 	 499.21182421  	 Language/Other languages/Austronesian & other languages/Tagalog For Beginners, - Teresita V. Ramos, Videa P. De Guzman
Teach Yourself_ Indonesian 	 499.22182421  	 Language/Other languages/Austronesian & other languages/Teach Yourself Indonesian - John B Kwee
TheGirlWithoutASound_Book_isiZulu - draft02 	 823.92  	 Literature/English & Old English literatures/English fiction/The Girl Without A Sound - Buhle Ngaba
The Grammar of Words_ An Introduction to Linguistic Morphology (Oxford Textbooks in Linguistics) 	 415.9  	 Language/Linguistics/Grammar/The Grammar Of Words_ An Introduction To Linguistic Morphology - Oxford University Press [Publisher], G. E. Booij
The Little Schemer 	 005.133  	 Computer science, information & general works/Computer science, knowledge & systems/Computer programming, programs & data/The Little Schemer - Daniel P. Friedman, Matthias Felleisen
The Pocket Handbook of Image Processing Algorithms In C 	 621.3670285533  	 Technology/Engineering/Applied physics/The Pocket Handbook Of Image Processing Algorithms In C - Harley R. Myler, Arthur R. Weeks
The Study of Language 	 410.9 : Language/Linguistics/Linguistics/History Of The Language Sciences_ An International Handbook On The Evolution Of The Study Of Language From The Beginnings To The Present = Geschichte Der Sprachwissenschaften : Ein Internationales Handbuch Zur Entwicklung Der Sprachforschung Von Den Anfängen Bis Zur Gegenwart = Histoire Des Sciences Du Langage  	 Manuel International Sur L'Évolution De L'Étude Du Langage Des Origines À Nos Jours - Sylvain Auroux, Hans-Josef Niederehe, E. F. K. Koerner, Sören Philipps
think-python 	 005.133  	 Computer science, information & general works/Computer science, knowledge & systems/Computer programming, programs & data/Think Python - Allen Downey
Tiuelis titlajtlajtos náhuatl _ Puede hablar el náhuatl 	 497.45281  	 Language/Other languages/North American native languages/Tiuelis Titlajtlajtos Náhuatl = Puede Hablar El Náhuatl_ Náhuatl De Guerrero Y Español -
Tlingit 	 979.800497  	 History & geography/History of North America/Great Basin & Pacific Slope region/Tlingit Indians Of Alaska - Bishop of Tomsk Anatolīĭ, Sergei Kan
Tongan 	 863  	 Literature/Spanish & Portuguese literatures/Spanish fiction/Cien Años De Soledad - Gabriel García Márquez, Jacques Joset, Curt Meyer-Clason
Tunumiit oraasiat_ Tunumiut oqaasii The East Greenlandic Inuit language 	 497.1  	 Language/Other languages/North American native languages/Tunumiit Oraasiat =_ Tunumiut Oqaasii = The East Greenlandic Inuit Language - Louis-Jacques Dorais, Université Laval., Pierre Robbe
Urdu-Script 	 491.43982421  	 Language/Other languages/East Indo-European & Celtic languages/Beginner'S Urdu Script - Richard Delacy
Warlpiri 	 401.43  	 Language/Language/Philosophy & theory/The Semantics Of Polysemy_ Reading Meaning In English And Warlpiri - Inc ebrary, Nick Riemer
Webbots, Spiders, and Screen Scrapers 	 025.04  	 Computer science, information & general works/Library & information sciences/Library operations/Webbots, Spiders, And Screen Scrapers_ A Guide To Developing Internet Agents With PHP/CURL - Michael Schrenk
Wicked Cool Perl Scripts Useful Perl Scripts That Solve Difficult Problems 	 005.133  	 Computer science, information & general works/Computer science, knowledge & systems/Computer programming, programs & data/Wicked Cool Perl Scripts_ Useful Perl Scripts That Solve Difficult Problems - Steve Oualline
Windows Commands 	 005.446  	 Computer science, information & general works/Computer science, knowledge & systems/Computer programming, programs & data/PowerShell Essentials_ Windows Commands - Jamie Campbell
Women, Fire, and Dangerous Things 	 401.9  	 Language/Language/Philosophy & theory/Women, Fire, And Dangerous Things_ What Categories Reveal About The Mind - George 1941- Lakoff
Your First 100 Words in Pashto 	 491.593  	 Language/Other languages/East Indo-European & Celtic languages/Your First 100 Words In Pashto_ Pashto For Total Beginners Through Puzzles And Games - Mahmoud Gaafar, Jane Wightwick, Akhtarjan Kohistani, Akber Hargar
ZeroMQ 	 004.6  	 Computer science, information & general works/Computer science, knowledge & systems/Data processing & computer science/ZeroMQ - Faruk Akgul
Abhijnana Sakuntalam 	 891.22  	 Literature/Other literatures/East Indo-European & Celtic literatures/The Recognition Of Shakúntala - Kālidāsa, M. B. 1904-2005 Emeneau, Rabindranath Tagore, Somadeva Vasudeva
A History of Old Norse Poetry and Poetics 	 839.61009  	 Literature/German & related literatures/Other Germanic literatures/A History Of Old Norse Poetry And Poetics - Margaret Clunies Ross
A Little Larger Than the Entire Universe 	 861.141  	 Literature/Spanish & Portuguese literatures/Spanish poetry/A Little Larger Than The Entire Universe_ Selected Poems - Fernando Pessoa, Richard Zenith
Anukul 	 922.94  	 History & geography/Biography & genealogy/Optional/Ocean In A Teacup;_ The Story Of Sree Sree Thakur Anukul Chandra, - Ray A. Hauserman
A series of Unfortunate Events - 2 	 813.6 : Literature/American literature in English/American fiction in English/The Reptile Room_ A Series Of Unfortunate Events 	 #2 - Lemony Snicket
A series of Unfortunate Events - 3 	 813.54  	 Literature/American literature in English/American fiction in English/A Series Of Unfortunate Events_ Book The Third.,. The Wide Window - Lemony Snicket
A series of Unfortunate Events - 4 	 813.54  	 Literature/American literature in English/American fiction in English/A Series Of Unfortunate Events,_ 4. The Miserable Mill - Lemony Snicket
A Thousand Yearnings 	 891.43909  	 Literature/Other literatures/East Indo-European & Celtic literatures/A Thousand Yearnings_ A Book Of Urdu Poetry And Verse -
A Worldly Country 	 811.54  	 Literature/American literature in English/American poetry in English/A Worldly Country_ New Poems - John Ashbery
Beautiful Boy 	 362.299  	 Social sciences/Social problems & social services/Social welfare problems & services/Beautiful Boy_ A Father'S Journey Through His Son'S Addiction - David Sheff
Book of Blues 	 781.6430922  	 Arts & recreation/Music/General principles & musical forms/The Big Book Of Blues_ A Biographical Encyclopedia - Robert Santelli
Bram Stoker - Dracula 	 823.8  	 Literature/English & Old English literatures/English fiction/Bram Stoker, Dracula And The Victorian Gothic Stage - Catherine Wynne
City of Joy 	 954.14  	 History & geography/History of Asia/South Asia; India/The City Of Joy - Dominique Lapierre
Collected Poems of Ezra Pound 	 811.5  	 Literature/American literature in English/American poetry in English/Personae_ The Collected Poems Of Ezra Pound, Including Ripostes, Lustra, Homage To Sextus Propertius, H.S. Mauberley - Ezra Pound
Complete Poems and Selected Letters of John Keats 	 821.7  	 Literature/English & Old English literatures/English poetry/Complete Poems And Selected Letters Of John Keats - John Keats
Complete Poems of Robert Frost 	 811  	 Literature/American literature in English/American poetry in English/Complete Poems Of Robert Frost - Robert Frost
Complete Works of Edgar Allan Poe 	 818.309  	 Literature/American literature in English/American miscellaneous writings/The Complete Works Of Edgar Allan Poe; - James Albert Harrison, Edgar Allan Poe
Complete Works of William Shakespeare 	 822.33  	 Literature/English & Old English literatures/English drama/Complete Works Of William Shakespeare - William George Clark, W. J. 1843-1906 Craig, William Shakespeare, William Aldis Wright
Dante Alighieri - La divine comedie 	 851.1  	 Literature/Italian, Romanian & related literatures/Italian poetry/The Divine Comedy Of Dante Alighieri - 1265-1321 Dante Alighieri, Charles Eliot Norton, Henry Wadsworth Longfellow, Henry Francis Cary
Dante Alighieri - translated by Mark Musa 	 851.1  	 Literature/Italian, Romanian & related literatures/Italian poetry/Vita Nuova Of Dante Alighieri ; Translated By Mark Musa - 1265-1321 Dante Alighieri
Diaries of Franz Kafka 1910-1913 	 834.912  	 Literature/German & related literatures/German essays/The Diaries Of Franz Kafka, 1910-1913 - Joseph 1909-1993 Kresh, Max Brod, Franz Kafka
Diaries of Franz Kafka -1914-1923 	 838  	 Literature/German & related literatures/German miscellaneous writings/The Diaries Of Franz Kafka, 1914-1923 - Martin Greenberg, Franz Kafka, Hannah 1906-1975 Arendt
Dictionary Stories 	 813.6  	 Literature/American literature in English/American fiction in English/Dictionary Stories_ Short Fictions And Other Findings - Jez Burrows
Dumpling Field - Haiku Of Issa 	 895.6134  	 Literature/Other literatures/Literatures of East & Southeast Asia/The Dumpling Field_ Haiku Of Issa - Noboru Fujiwara, Issa Kobayashi, Lucien Stryk
Ella Minnow Pea 	 813.6  	 Literature/American literature in English/American fiction in English/Ella Minnow Pea_ A Progressively Lipogrammatic Epistolary Fable - Mark Dunn
Extracting the stone of Madness 	 861.64  	 Literature/Spanish & Portuguese literatures/Spanish poetry/Extracting The Stone Of Madness_ Poems 1962-1972 - Alejandra Pizarnik, Yvette Siegert
First thought, best thought 	 811.54  	 Literature/American literature in English/American poetry in English/First Thought, Best Thought_ 108 Poems - Chögyam Trungpa, David I. Rome
Gitanjali 	 891.4414  	 Literature/Other literatures/East Indo-European & Celtic literatures/Gitanjali =_ Song Offerings - Rabindranath Tagore, W. B. 1865-1939 Yeats, England) India Society (London, Joe Winter
Haiku - An Anthology of Japanese Poems 	 895.6104108  	 Literature/Other literatures/Literatures of East & Southeast Asia/Haiku_ An Anthology Of Japanese Poems - Fumiko Y. Yamamoto, Stephen Addiss, Akira Y. Yamamoto
Hazaron Khawaishen Aisi 	 891.4391008  	 Literature/Other literatures/East Indo-European & Celtic literatures/Hazaron Khawaishen Aisi_ The Wonderful World Of Urdu Ghazals -
Hölderlin, Friedrich_Adler, Jeremy D Louth, Charlie - Essays and Letters 	 838.608  	 Literature/German & related literatures/German miscellaneous writings/Essays And Letters - Jeremy D. Adler, Charlie Louth, Friedrich Hölderlin
Hope in the Dark 	 303.4  	 Social sciences/Social sciences, sociology & anthropology/Social processes/Hope In The Dark_ Untold Histories, Wild Possibilities - REBECCA SOLNIT
Horace Odes 	 874.01  	 Literature/Latin & Italic literatures/Latin lyric poetry/Odes And Epodes - Paul Shorey, Charles E. 1858-1921 Bennett, David R. Slavitt, Horace
I Heard God Laughing Poems of Hope and Joy 	 891.5511 : Literature/Other literatures/East Indo-European & Celtic literatures/I Heard God Laughing_ Poems Of Hope And Joy  	 Renderings Of Hafiz - Daniel James Ladinsky, active 14th century Ḥāfiẓ, H. Wilberforce 1840-1905 Clarke
I Know Why the Caged Bird Sings - Maya Angelou 	 818.5409  	 Literature/American literature in English/American miscellaneous writings/I Know Why The Caged Bird Sings, Maya Angelou - Selena Ward
Inferno 	 851.1  	 Literature/Italian, Romanian & related literatures/Italian poetry/The Divine Comedy Of Dante Alighieri - 1265-1321 Dante Alighieri, Charles Eliot Norton, Henry Wadsworth Longfellow, Henry Francis Cary
Invisible Cities 	 853.914  	 Literature/Italian, Romanian & related literatures/Italian fiction/Invisible Cities - Italo Calvino, Aurora Bernárdez, William Weaver, César Palma
Japanese Death Poems 	 895.610080354  	 Literature/Other literatures/Literatures of East & Southeast Asia/Japanese Death Poems =_ [Jisei - Yoel Hoffmann
Junky 	 813.54  	 Literature/American literature in English/American fiction in English/Junky - William S. Burroughs, Oliver Harris
Kamasutra 	 704.94280  	 Arts & recreation/Arts/Special topics in fine & decorative arts/Kama Sutra - Klaus Carl
Letters of Rainer Maria Rilke, 1892-1910 	 831  	 Literature/German & related literatures/German poetry/Letters Of Rainer Maria Rilke, 1892-1910 - Jane Bannard Greene, M. D. 1892-1985 Herter Norton, Rainer Maria Rilke
Light and Dark 	 895.6342  	 Literature/Other literatures/Literatures of East & Southeast Asia/Light And Darkness_ An Unfinished Novel - René de Ceccatty, V. H. 1926-2016 Viglielmo, John Nathan, Sōseki Natsume
Love's subtle Magic 	 891.4309921297  	 Literature/Other literatures/East Indo-European & Celtic literatures/Love'S Subtle Magic_ An Indian Islamic Literary Tradition, 1379-1545 - Aditya Behl, Wendy Doniger
Manimekalai 	 894.81111  	 Literature/Other literatures/Altaic, Uralic, Hyperborean & Dravidian/Manimekhalai_ The Dancer With The Magic Bowl - Alain Daniélou, Cāttan̲ār, Tirunelvēli Ten̲n̲intiya Caivacittānta Nūr̲patippuk Kal̲akam, Ti. Vē. Kōpālayyar
Micromegas - Voltaire 	 843.00917  	 Literature/French & related literatures/French fiction/Une Œuvre -- Zadig Et Micromégas, Voltaire ;_ Un Thème -- La Fiction Satirique, J. Prévert, A. De Saint-Exupéry, B. Vian -- - Michel Barlow
Miklós Radnóti 	 894.51113  	 Literature/Other literatures/Altaic, Uralic, Hyperborean & Dravidian/Foamy Sky_ The Major Poems Of Miklós Radnóti - Miklós Radnóti, Frederick Turner, Zsuzsanna Ozsváth
Mother, daughter, me 	 070.92  	 Computer science, information & general works/News media, journalism & publishing/News media, journalism & publishing/Mother, Daughter, Me_ A Memoir - Katie Hafner
Mountain 	 833.8  	 Literature/German & related literatures/German fiction/Heidi - Helen B. Dole, William Sharp, Johanna Spyri, Jessie Willcox Smith
Naked Lunch 	 813.54  	 Literature/American literature in English/American fiction in English/Naked Lunch - James Grauerholz, Eric Kahane, William S. Burroughs, Barry Miles
Necromancer 	 823.914  	 Literature/English & Old English literatures/English fiction/The Necromancer - Michael Scott, María Angulo Fernández
Niels Lyhne 	 839.8136  	 Literature/German & related literatures/Other Germanic literatures/Niels Lyhne - Tiina Nunnally, M. von 1853-1895 Borch, Hanna Astrup Larsen, J. P. Jacobsen1847-1885  (Jens Peter)
Night and Day 	 823.912  	 Literature/English & Old English literatures/English fiction/Night And Day - Suzanne Raitt, Angelica Garnett, Julia Briggs, Virginia Woolf
Parva1 	 294.544 : Religion/Other religions/Religions of Indic origin/Ath?Ri Mah?Bh?Rata?Diparva Prr?Abhyate_ [Mah?Bh?Rata Med N?Laka??Ha'S Kommentar] : I-II Parvan (?Diparva Og Sa?R?Parva)  	 1 -
Parva2 	 294.5925  	 Religion/Other religions/Religions of Indic origin/Śrībhaviṣyamahāpurāṇam =_ The Bhaviṣyamahāpurāṇam - Rajendra Nath Sharma, Nag Sharan Singh
Pictures and Tears 	 750.11  	 Arts & recreation/Painting/Painting & paintings/Pictures &Amp; Tears_ A History Of People Who Have Cried In Front Of Paintings - James Elkins
Purgatorio 	 851.1  	 Literature/Italian, Romanian & related literatures/Italian poetry/The Divine Comedy Of Dante Alighieri - 1265-1321 Dante Alighieri, Charles Eliot Norton, Henry Wadsworth Longfellow, Henry Francis Cary
Raghuvanca 	 891.238  	 Literature/Other literatures/East Indo-European & Celtic literatures/The Raghuvança,_ The Story Of Raghu'S Line - Kālidāsa
Rama Retold 	 823.91  	 Literature/English & Old English literatures/English fiction/Rama Retold - Aubrey Menen
Screams From the Balcony 	 811.54  	 Literature/American literature in English/American poetry in English/Screams From The Balcony_ Selected Letters, 1960-1970 - Charles Bukowski, Seamus Cooney
Selected Poems of Pablo Neruda 	 861.62  	 Literature/Spanish & Portuguese literatures/Spanish poetry/Selected Poems Of Pablo Neruda - Pablo Neruda
Shadow Train Poems 	 811.54  	 Literature/American literature in English/American poetry in English/Shadow Train_ Poems - Aaron Copland, John Ashbery
Sonnets to Orpheus 	 831.912  	 Literature/German & related literatures/German poetry/Duino Elegies - J. B. 1902-1963 Leishman, Stephen Spender, Hogarth Press, [Publisher], Rainer Maria Rilke
Storm for the Living and the Dead 	 811.54  	 Literature/American literature in English/American poetry in English/Storm For The Living And The Dead_ Uncollected And Unpublished Poems - Charles Bukowski, Abel Debritto
Surfacing 	 813.54  	 Literature/American literature in English/American fiction in English/Surfacing - Margaret Atwood
The Adding Machine 	 814.54  	 Literature/American literature in English/American essays in English/The Adding Machine_ Selected Essays - William S. Burroughs
The Answer 	 813.6  	 Literature/American literature in English/American fiction in English/The Ask And The Answer - Patrick Ness, Andrej Hiti Ožinger
The Birth of the War God 	 891.238  	 Literature/Other literatures/East Indo-European & Celtic literatures/The Birth Of The War-God,_ A Poem, Tr. From The Sanskrit Into English Verse, - Ralph T. H. 1826-1906 Griffith
The Book Thief 	 823.92  	 Literature/English & Old English literatures/English fiction/The Book Thief - Trudy White, Laura Martín de Dios, Markus Zusak, Alexandra Ernst
The Complete poems of Emily Dickenson 	 811.3  	 Literature/American literature in English/American poetry in English/The Complete Poems Of Emily Dickenson [I.E. Dickinson] - Emily Dickinson
The Complete Works of Rabindranath Tagore 	 823.8  	 Literature/English & Old English literatures/English fiction/Il Mastino Dei Baskerville - Arthur Conan Doyle
The divine Narcissus 	 862  	 Literature/Spanish & Portuguese literatures/Spanish drama/The Divine Narcissus =_ El Divino Narciso - Sister Juana Inés de la Cruz, Robin Ann Rice, Renée Domeier, Patricia A. Peters
The Epic of Gilgamesh 	 782.43  	 Arts & recreation/Music/Vocal music/The Epic Of Gilgamesh - Bohuslav Martinů
The Essential Ginsberg 	 811.54  	 Literature/American literature in English/American poetry in English/The Essential Ginsberg - Michael Schumacher, Allen Ginsberg
The haiku handbook 	 808.1  	 Literature/Literature, rhetoric & criticism/Rhetoric & collections of literature/The Haiku Handbook_ How To Write, Share, And Teach Haiku - Penny Harter, William J. Higginson
The Handmaid's Tale 	 813.54  	 Literature/American literature in English/American fiction in English/The Handmaid'S Tale - Renee Nault, Elsa Mateo, Margaret Atwood, Valerie Martin
The Homeric Hymns 	 883.01  	 Literature/Classical & modern Greek literatures/Classical Greek epic poetry & fiction/The Homeric Hymns - Diane J. Rayor, Michael Crudden, Homero, Apostolos N. Athanassakis
The Left Hand of Darkness 	 813.54  	 Literature/American literature in English/American fiction in English/The Left Hand Of Darkness - Neil Gaiman, Ursula K. Le Guin, Gisela Stege, Charlie Jane Anders
The Mahabharata A Shortened Modern Prose 	 294.5923  	 Religion/Other religions/Religions of Indic origin/The Mahabharata_ A Shortened Modern Prose Version Of The Indian Epic - R. K. Narayan, Wendy Doniger, R. K Laxman
The Orphic Hymns 	 292.38  	 Religion/Other religions/Greek & Roman religion/The Orphic Hymns -
The Poetry of Rainer Maria Rilke 	 831.91  	 Literature/German & related literatures/German poetry/Translations From The Poetry Of Rainer Maria Rilke - M. D. 1892-1985 Herter Norton, Rainer Maria Rilke
The Sandman Vol 1 Preludes and Nocturnes 	 741.5973  	 Arts & recreation/Drawing & decorative arts/Drawing & drawings/The Sandman_ Vol. 1,. Preludes &Amp; Nocturnes - Neil Gaiman
The selected prose of Fernando Pessoa 	 869.84108  	 Literature/Spanish & Portuguese literatures/Portuguese literature/The Selected Prose Of Fernando Pessoa - Fernando Pessoa, Richard Zenith
The unknown Kerouac 	 813.54  	 Literature/American literature in English/American fiction in English/The Unknown Kerouac_ Rare, Unpublished &Amp; Newly Translated Writings - Todd F. Tietchen, Jack Kerouac, Jean-Christophe Cloutier
Tortilla Flat 	 813.52  	 Literature/American literature in English/American fiction in English/Cannery Row - David S. Ward, John Steinbeck, Rudolf Frank, Nick Nolte
Twenty Love Poems and a Song of Despair 	 861  	 Literature/Spanish & Portuguese literatures/Spanish poetry/Twenty Love Poems And A Song Of Despair - W.S Merwin, Andy Warhol, Pablo Neruda
Tyrannosaurus lex 	 793.734  	 Arts & recreation/Sports, games & entertainment/Indoor games & amusements/Tyrannosaurus Lex_ The Marvelous Book Of Palindromes, Anagrams, And Other Delightful And Outrageous Wordplay - Rod L. Evans
Unseen Rain 	 891.5511 : Literature/Other literatures/East Indo-European & Celtic literatures/Rumi_ The Big Red Book  	 The Great Masterpiece Celebrating Mystical Love And Friendship - A. J. 1905-1969 Arberry, Maulana Jalāl al-Dīn Rūmī, Hasan Javadi, Ehsan Yarshater
Velveteen Rabbit 	 813  	 Literature/American literature in English/American fiction in English/The Velveteen Rabbit, Or, How Toys Become Real - Margery Williams Bianco, Michael Green, Michael Hague, William Nicholson
Wait Till I’m Dead 	 811.54  	 Literature/American literature in English/American poetry in English/Wait Till I'M Dead_ Uncollected Poems - Bill Morgan, Rachel Zucker, Allen Ginsberg
War of the Foxes 	 811.6  	 Literature/American literature in English/American poetry in English/War Of The Foxes - Richard Siken
White Oleander 	 813.54  	 Literature/American literature in English/American fiction in English/White Oleander_ A Novel - Janet Fitch
Analytical Combinatorics 	 511.6  	 Science/Mathematics/General principles of mathematics/Analytic Combinatorics - Philippe Flajolet, Robert Sedgewick
A Walk Through Combinatorics 	 511.6  	 Science/Mathematics/General principles of mathematics/A Walk Through Combinatorics_ An Introduction To Enumeration And Graph Theory - Miklós Bóna
Discrete Mathematics 	 510  	 Science/Mathematics/Mathematics/Discrete Mathematics_ Elementary And Beyond - László Lovász, J. Pelikán, K. Vesztergombi, K. Vsztergombi
Game Theory - Hans Peters 	 519.3  	 Science/Mathematics/Probabilities & applied mathematics/Game Theory_ A Multi-Leveled Approach - Hans Peters, Hans Peters
Geometry Revisited 	 513.5  	 Science/Mathematics/Arithmetic/Geometry Revisited - Samuel L. Greitzer, H. S. M. Coxeter1907-2003  (Harold Scott Macdonald)
group theory 	 302.34  	 Social sciences/Social sciences, sociology & anthropology/Social interaction/Joining Together_ Group Theory And Group Skills - Frank P. Johnson, David W. Johnson, Frank P. 1935- Johnson
Introduction to Real Analysis -Bartle and Sherbert 	 515  	 Science/Mathematics/Analysis/Introduction To Real Analysis - Robert G. Bartle, Donald R. Sherbert
Linear Algebra Done Right 	 512.5  	 Science/Mathematics/Algebra/Linear Algebra Done Right - Sheldon Jay Axler, Springer Science+Business Media [Publisher]
Marek Jarnicki, Peter Pflug - Continuous Nowhere Differentiable Functions_ The Monsters of Analysis (2016) 	 515.222  	 Science/Mathematics/Analysis/Continuous Nowhere Differentiable Functions_ The Monsters Of Analysis - Marek Jarnicki, Peter Pflug
Modelling Fluid Flow 	 532.051015118  	 Science/Physics/Fluid mechanics; liquid mechanics/Modelling Fluid Flow_ The State Of The Art - Tamás Lajos, János Vad
Reading Writing And Proving 	 510  	 Science/Mathematics/Mathematics/Reading, Writing, And Proving_ A Closer Look At Mathematics - Ulrich Daepp, Pamela Gorkin
Sphere Packings, Lattices and Groups 	 511.6  	 Science/Mathematics/General principles of mathematics/Sphere Packings, Lattices, And Groups - N. J. A. 1939- Sloane, John H. Conway
The math problems notebook 	 510.76  	 Science/Mathematics/Mathematics/The Math Problems Notebook - Louis Funar, Valentin BojuAll Shapes and Sizes 	 516  	 Science/Mathematics/Geometry/All Shapes And Sizes - Shirley Hughes
Murderous Maths 	 510  	 Science/Mathematics/Mathematics/Murderous Maths - Kjartan Poskitt, Trevor Dunton, Xiyi Zhang
The Most Epic Book of Maths EVER 	 510  	 Science/Mathematics/Mathematics/The Most Epic Book Of Maths Ever - Kjartan Poskitt, Rob Davis[ 06 Elements of Mathematics] - Functions of a Real Variable 	 515.8  	 Science/Mathematics/Analysis/Functions Of A Real Variable_ Elementary Theory - Philip G. Spain, Nicolas Bourbaki
[ 07 Elements of Mathematics] - Topological Vector Spaces 	 510.9  	 Science/Mathematics/Mathematics/Elements Of The History Of Mathematics - J. D. P. Meldrum, Nicolas Bourbaki
[ 08 Elements of Mathematics] - Integration - Ch 1 to 6 	 510  	 Science/Mathematics/Mathematics/Elements Of Mathematics_ 1. Chapters 1 - 6 / Transl. By Sterling K. Berberian - Nicolas Bourbaki
Al-tafsir Al-kabir 	 297.1226 : Religion/Other religions/Islam, Bábism & Bahá'í Faith/The Great Exegesis =_ Al-Tafsīr Al-Kabīr  	 Volume I,. The Fātiḥa - Muḥammad Ibn-ʿUmar 1149-1210 Faḫr-ad-Dīn ar-Rāzī
A Mathematicians Apology 	 510  	 Science/Mathematics/Mathematics/A Mathematician'S Apology, - Godfrey Harold Hardy, C. P Snow
A new kind of Science 	 500  	 Science/Science/Natural sciences & mathematics/A New Kind Of Science - Stephen Wolfram
Bible and Qur'an - Essays in Scriptural Intertextuality 	 220.6  	 Religion/The Bible/Bible/Bible And Qurʼān_ Essays In Scriptural Intertextuality - John C. Reeves
Book of Knowledge 	 031  	 Computer science, information & general works/Encyclopedias & books of facts/Encyclopedias in American English/The New Book Of Knowledge - Grolier Incorporated
Close to the Machine Technophilia and Its Discontents 	 005.1092 : Computer science, information & general works/Computer science, knowledge & systems/Computer programming, programs & data/Close To The Machine_ Technophilia And Its Discontents  	 A Memoir - Ellen Ullman, Jaron Lanier
Computer System Architecture 	 001.64  	 Computer science, information & general works/Computer science, knowledge & systems/Knowledge/Computer System Architecture - M. Morris Mano
Concepts of Modern Physics 	 539  	 Science/Physics/Modern physics/Concepts Of Modern Physics - Arthur Beiser
Concrete Mathematics 	 510  	 Science/Mathematics/Mathematics/Concrete Mathematics_ A Foundation For Computer Science - Oren Patashnik, Donald Ervin Knuth, Ronald L. Graham
Cosmographia 	 913  	 History & geography/Geography & travel/Geography of & travel in ancient world/Pomponius Mela'S Description Of The World - A. Silberman, F. E. Romer, Pomponius Mela, Karl Frick
Cubist 	 759.0632  	 Arts & recreation/Painting/Historical, geographic & persons treatment/The Cubist Painters - Peter Read, Lionel Abel, Guillaume Apollinaire
Darwins camera art and photography in the theory of evolution 	 704.9495  	 Arts & recreation/Arts/Special topics in fine & decorative arts/Darwin'S Camera_ Art And Photography In The Theory Of Evolution - Phillip Prodger
Darwins Notebooks, 1836-1844_ Geology, Transmutation of Species, Metaphysical Enquiries 	 575.0162  	 Science/Life sciences; biology/Specific parts of & systems in plants/Charles Darwin'S Notebooks, 1836-1844_ Geology, Transmutation Of Species, Metaphysical Enquiries - Charles Darwin
Fearful symmetry 	 813.54  	 Literature/American literature in English/American fiction in English/Her Fearful Symmetry_ A Novel - Audrey Niffenegger, Brigitte Jakobeit
Fooled by Randomness 	 123.3  	 Philosophy & psychology/Epistemology/Determinism & indeterminism/Fooled By Randomness_ The Hidden Role Of Chance In Life And In The Markets - Nassim Nicholas Taleb
Forbidden Sexual Behavior and Morality 	 301.4243  	 Social sciences/Social sciences, sociology & anthropology/Sociology & anthropology/Forbidden Sexual Behavior And Morality_ An Objective Re-Examination Of Perverse Sex Practices In Different Cultures - Robert E. L. Masters
Game, Set and Math 	 793.74  	 Arts & recreation/Sports, games & entertainment/Indoor games & amusements/Game, Set, And Math_ Enigmas And Conundrums - Ian Stewart
Geological Observations on South America 	 509  	 Science/Science/Historical, geographic & persons treatment/Geological Observations On South America_ Being The Third Part Of The Geology Of The Voyage Of The Beagle, Under The Command Of Capt. Fitzroy, R.N. During The Years 1832 To 1836 - Charles Darwin, Bern Dibner, Edward Forbes, George Brettingham Sowerby
Geometric algebra 	 516  	 Science/Mathematics/Geometry/Geometric Algebra - Emil Artin
Handbook of Greek Mythology 	 292  	 Religion/Other religions/Greek & Roman religion/A Handbook Of Greek Mythology_ Including Its Extension To Rome - H. J. Rose1883-1961  (Herbert Jennings)
Handbook Of Ornament 	 745  	 Arts & recreation/Drawing & decorative arts/Decorative arts/Handbook Of Ornament_ A Grammar Of Art, Industrial And Architectural Designing In All Its Branches For Practical As Well As Theoretical Use - Franz Sales Meyer
Heraclitus The Cosmic Fragments 	 182.4  	 Philosophy & psychology/Ancient, medieval & eastern philosophy/Pre-Socratic Greek philosophies/Heraclitus;_ The Cosmic Fragments - G. S. Kirk1921-2003  (Geoffrey Stephen)
Hexaflexagons, Probability Paradoxes, and the Tower of Hanoi 	 793.74  	 Arts & recreation/Sports, games & entertainment/Indoor games & amusements/Hexaflexagons, Probability Paradoxes, And The Tower Of Hanoi_ Martin Gardner'S First Book Of Mathematical Puzzles And Games - Martin Gardner, Mathematical Association of America
History of Birds 	 598  	 Science/Animals (Zoology)/Birds/A General History Of Birds - John Latham
Human Sexual Inadequacy 	 616.6  	 Technology/Medicine & health/Diseases/Human Sexual Inadequacy - Virginia E. Johnson, William H. Masters
Human Sexual Response 	 612.6  	 Technology/Medicine & health/Human physiology/Human Sexual Response - New York Academy of Medicine [Donor], Virginia E. Johnson, William H. Masters
Illuminating in Micrography - The Catalan Micrography Mahzor 	 745.674924  	 Arts & recreation/Drawing & decorative arts/Decorative arts/Illuminating In Micrography_ The Catalan Micrography Maḥzor-- MS Heb 8°6527 In The National Library Of Israel - Dalia-Ruth Halperin
Journal of Researches into the Geology and Natural History of The Voyage of Beagle 	 574  	 Science/Life sciences; biology/Unassigned/Journal Of Researches Into The Geology And Natural History Of The Various Countries Visited By H.M.S. Beagle - Julius Victor Carus, Charles Darwin, Robert Fitzroy, John Murray (Firm) [Contributor; Publisher]
Knot Book 	 514.224  	 Science/Mathematics/Topology/The Knot Book_ An Elementary Introduction To The Mathematical Theory Of Knots - Colin Adams1956-  (Colin Conrad)
Learn Latin from the Romans 	 478.2421  	 Language/Latin & Italic languages/Classical Latin usage/Learn Latin From The Romans_ A Complete Introductory Course Using Textbooks From The Roman Empire - Eleanor Dickey
Maps of the Ancient World 	 912.3  	 History & geography/Geography & travel/Atlases, maps, charts & plans/Atlas Antiquus;_ Twelve Maps Of The Ancient World For Schools And Colleges - Heinrich Kiepert
Masters of Sex 	 306.7092273  	 Social sciences/Social sciences, sociology & anthropology/Culture & institutions/Masters Of Sex_ The Life And Times Of William Masters And Virginia Johnson, The Couple Who Taught America How To Love - Thomas Maier
Mathematical Problems and Proofs Combinatorics, Number Theory, and Geometry 	 511.6  	 Science/Mathematics/General principles of mathematics/Mathematical Problems And Proofs_ Combinatorics, Number Theory, And Geometry - Branislav Kisačanin
Mathnawi of Jalaluldin Vol1 	 891.5511  	 Literature/Other literatures/East Indo-European & Celtic literatures/Rūmī'S Mystical Design_ Reading The Mathnawī, Book One - S. C. R. Weightman, Seyed Ghahreman Safavi
Music and Mathematics - From Pythagoras to Fractals 	 781.2  	 Arts & recreation/Music/General principles & musical forms/Music And Mathematics_ From Pythagoras To Fractals - John Fauvel
Narcissus and Oedipus 	 155.418  	 Philosophy & psychology/Psychology/Differential & developmental psychology/Narcissus And Oedipus_ The Children Of Psychoanalysis - Victoria Hamilton
Notebooks of Leonardo da Vinci 	 709  	 Arts & recreation/Arts/Historical, geographic & persons treatment/The Notebooks Of Leonardo Da Vinci - da Vinci Leonardo, R. C. Bell, Edward McCurdy, Jean Paul Richter
Notes on Introductory Combinatorics 	 511.6  	 Science/Mathematics/General principles of mathematics/Notes On Introductory Combinatorics - Robert E. 1948- Tarjan, George Pólya, Donald R. Woods
One, two, three - infinity 	 500  	 Science/Science/Natural sciences & mathematics/One Two Three ... Infinity_ Facts &Amp; Speculations Of Science - George Gamow
On Looking 	 158.1  	 Philosophy & psychology/Psychology/Applied psychology/On Looking_ Eleven Walks With Expert Eyes - Alexandra Horowitz
On numbers and Games 	 519.3  	 Science/Mathematics/Probabilities & applied mathematics/On Numbers And Games - John H. Conway
On quaternions and octonions their geometry, arithmetic and symmetry 	 512.5  	 Science/Mathematics/Algebra/On Quaternions And Octonions_ Their Geometry, Arithmetic, And Symmetry - Derek Alan Smith, John H. Conway
Oulipo 	 840.6044  	 Literature/French & related literatures/Literatures of Romance languages/Oulipo_ A Primer Of Potential Literature - Warren F. Motte
Physics From Symmetry 	 539.725  	 Science/Physics/Modern physics/Physics From Symmetry - Jakob Schwichtenberg
Poetry of Physics and the Physics of Poetry 	 530  	 Science/Physics/Physics/The Poetry Of Physics And The Physics Of Poetry - Robert K. Logan
Quantum Mechanics 	 530.12  	 Science/Physics/Physics/The Principles Of Quantum Mechanics - P. A. M. Dirac1902-1984  (Paul Adrien Maurice)
Quran Saheeh 	 297.122  	 Religion/Other religions/Islam, Bábism & Bahá'í Faith/The Qur'An_ Saheeh International Translation -
Reflecting Narcissus - A Queer Aesthetic 	 809.93353  	 Literature/Literature, rhetoric & criticism/History, description & criticism/Reflecting Narcissus_ A Queer Aesthetic - Steven Bruhm
Regular algebra and Finite machines 	 629.891  	 Technology/Engineering/Other branches of engineering/Regular Algebra And Finite Machines, - John H. Conway
Remarkable Curves 	 516  	 Science/Mathematics/Geometry/Remarkable Curves - Aleksej Ivanovič Markuševič
Sacred Geometry for Artists, Dreamers, and Philosophers Secrets of Harmonic Creation 	 133.33  	 Philosophy & psychology/Parapsychology & occultism/Specific topics in parapsychology & occultism/Sacred Geometry For Artists, Dreamers, And Philosophers_ Secrets Of Harmonic Creation - John Oscar Lieben
Sacred Mathematics - Japanese Temple Geometry 	 510.952  	 Science/Mathematics/Mathematics/Sacred Mathematics_ Japanese Temple Geometry - Hidetoshi Fukagawa
Star Maps 	 523.8  	 Science/Astronomy/Specific celestial bodies & phenomena/Star Maps_ History, Artistry, And Cartography - Nick Kanas
Stellar Structure And Evolution 	 523.8  	 Science/Astronomy/Specific celestial bodies & phenomena/Stellar Structure And Evolution - A. 1927-1992 Weigert, A. Weiss, Rudolf Kippenhahn
Stereographic Projection 	 551.8015165  	 Science/Earth sciences & geology/Geology, hydrology & meteorology/The Use Of Stereographic Projection In Structural Geology - F. C. Phillips1902-1982  (Frank Coles)
Surreal Numbers 	 512.7  	 Science/Mathematics/Algebra/An Introduction To The Theory Of Surreal Numbers - Harry Gonshor
The Art of Finding Nemo 	 741.58  	 Arts & recreation/Drawing & decorative arts/Drawing & drawings/The Art Of Finding Nemo - Mark Cotta Vaz, Walt Disney Company, Pixar (Firm)
The Art of Seduction 	 306.7  	 Social sciences/Social sciences, sociology & anthropology/Culture & institutions/The Art Of Seduction - Robert Greene
The Arts of Seduction 	 306.7  	 Social sciences/Social sciences, sociology & anthropology/Culture & institutions/The Arts Of Seduction - Seema Anand
The book of Numbers 	 512.7  	 Science/Mathematics/Algebra/The Book Of Numbers - Richard K. Guy, John H. Conway
The Colours of Infinity 	 514.742  	 Science/Mathematics/Topology/The Colours Of Infinity_ The Beauty And Power Of Fractals - Arthur C. 1917-2008 Clarke, Nigel Lesmoir-Gordon, Ian Stewart
The Cosmographia of Sebastian Munster 	 940.232072  	 History & geography/History of Europe/History of Europe/The Cosmographia Of Sebastian Münster_ Describing The World In The Reformation - Matthew McLean
The Doré Bible Gallery 	 220.3  	 Religion/The Bible/Bible/The Doré Bible Gallery_ Containing One Hundred Superb Illustrations And A Page Of Explanatory Letter-Press Facing Each - Gustave Doré
The Elegant Universe 	 539.7258  	 Science/Physics/Modern physics/The Elegant Universe_ Superstrings, Hidden Dimensions, And The Quest For The Ultimate Theory - Brian Greene
The Elements of Computing Systems 	 004.16  	 Computer science, information & general works/Computer science, knowledge & systems/Data processing & computer science/The Elements Of Computing Systems_ Building A Modern Computer From First Principles - Noam Nisan, Shimon Schocken
The Fourth Dimension 	 530.11  	 Science/Physics/Physics/Shadows Of Reality_ The Fourth Dimension In Relativity, Cubism, And Modern Thought - Tony Robbin
The Fractal Geometry of Nature 	 516.15  	 Science/Mathematics/Geometry/The Fractal Geometry Of Nature - Benoit B. Mandelbrot
The Gist of Mathematics 	 510  	 Science/Mathematics/Mathematics/The Gist Of Mathematics, - Justin H. Moore1884-  (Justin Hartley), Julio A. Mira
The Joy of Cats 	 511.3  	 Science/Mathematics/General principles of mathematics/Abstract And Concrete Categories_ The Joy Of Cats - Horst Herrlich, Jiří Adámek, George E. Strecker
The kinematics of Machinery 	 621.81  	 Technology/Engineering/Applied physics/The Kinematics Of Machinery_ Outlines Of A Theory Of Machines - Alex. B. W. 1847-1928 Kennedy, F. Reuleaux1829-1905  (Franz)
The Monte Carlo Method 	 518.282  	 Science/Mathematics/Numerical analysis/Simulation And The Monte Carlo Method - Reuven Y. Rubinstein, Dirk P. Kroese, John Wiley &amp; Sons [Publisher]
The Moral Landscape How Science Can Determine Human Values 	 171.2  	 Philosophy & psychology/Ethics/Ethical systems/The Moral Landscape_ How Science Can Determine Human Values - Sam Harris
The Mystery of Life's Origin 	 577  	 Science/Life sciences; biology/Ecology/The Mystery Of Life'S Origin_ Reassessing Current Theories - Roger L. Olsen, Charles B. Thaxton, Walter L. Bradley
The order of Time 	 530.11  	 Science/Physics/Physics/The Order Of Time - Sophie Lem, Carlo Rovelli, Simon Carnell, Erica Segre
The Origin of Species 	 576.82  	 Science/Life sciences; biology/Genetics and evolution/On The Origin Of Species By Means Of Natural Selection;_ Or, The Preservation Of Favoured Races In The Struggle For Life - Julius Victor Carus, W. F. 1943- Bynum, Charles Darwin, Paul Landacre
Theory of Nothing 	 111.5  	 Philosophy & psychology/Metaphysics/Ontology/Theory Of Nothing - Russell K. Standish
The Poem of Empedocles 	 113  	 Philosophy & psychology/Metaphysics/Cosmology/The Poem Of Empedocles_ A Text And Translation With An Introduction - Empedocles, Brad Inwood
The Secret Life of Pronouns 	 425.55  	 Language/English & Old English languages/English grammar/The Secret Life Of Pronouns_ What Our Words Say About Us - James W. Pennebaker
The Selfish Gene 	 591.5  	 Science/Animals (Zoology)/Specific topics in natural history/The Selfish Gene - Richard Dawkins, Hong Young Nam, [Translator], Karin de Sousa Ferreira
The sensual (quadratic) form 	 512.74  	 Science/Mathematics/Algebra/The Sensual (Quadratic) Form - Francis Yein Chei Fung, John H. Conway
The Tower of Hanoi – Myths and Maths 	 793.74  	 Arts & recreation/Sports, games & entertainment/Indoor games & amusements/The Tower Of Hanoi--Myths And Maths - Sandi Klavžar, Ciril Petr, Andreas M. Hinz
The Universe in Zero Words 	 512.94  	 Science/Mathematics/Algebra/The Universe In Zero Words_ The Story Of Mathematics As Told Through Equations - Dana Mackenzie
Timaeus 	 292.07  	 Religion/Other religions/Greek & Roman religion/The Nature Of The Gods - J. M. Ross, Marcus Tullius Cicero, P. G. Walsh, Arthur Stanley Pease
Tractatus Logico-Philosophicus 	 192  	 Philosophy & psychology/Modern western philosophy/Philosophy of British Isles/Tractatus Logico-Philosophicus - David Pears, Ludwig Wittgenstein, Bertrand Russell, Brian McGuinness
Tractus 	 192  	 Philosophy & psychology/Modern western philosophy/Philosophy of British Isles/The False Prison_ A Study Of The Development Of Wittgenstein'S Philosophy - Oxford University Press [Publisher], David Pears
Why Beauty Is Truth 	 539.725  	 Science/Physics/Modern physics/Why Beauty Is Truth_ A History Of Symmetry - Ian Stewart
Why Beauty Is Truth 	 539.725  	 Science/Physics/Modern physics/Why Beauty Is Truth_ A History Of Symmetry - Ian Stewart
Winning Ways for your mathematical plays 	 793.74  	 Arts & recreation/Sports, games & entertainment/Indoor games & amusements/Winning Ways For Your Mathematical Plays_ Volume 1 - Elwyn R. Berlekamp, Richard K. Guy, John H. Conway
Your Incredible Cat 	 599.74428  	 Science/Animals (Zoology)/Mammals/Your Incredible Cat_ Understanding The Secret Powers Of Your Pet - David Greene
Ants 	 813.6  	 Literature/American literature in English/American fiction in English/Two Bad Ants - Chris Van Allsburg
Building Up 	 690.0285  	 Technology/Building & construction/Buildings/The BIM Manager'S Handbook_ Guidance For Professionals In Architecture, Engineering, And Construction - Dominik Holzer
Cell biology, a short course 	 571.6  	 Science/Life sciences; biology/Physiology & related subjects/Cell Biology_ A Short Course - Stephen R. Bolsover, Hugh A White, Elizabeth A. 1950- Shephard
Cosmic Microwave Background 	 523.1  	 Science/Astronomy/Specific celestial bodies & phenomena/A Primer On The Physics Of The Cosmic Microwave Background - Massimo Giovannini
Dooms Day 	 813.54  	 Literature/American literature in English/American fiction in English/Doomsday Book - Connie Willis
Fractal Landscape 	 811.6  	 Literature/American literature in English/American poetry in English/An Interface For A Fractal Landscape - Ed Steck
Knot 	 843.91  	 Literature/French & related literatures/French fiction/Vipers' Tangle - Gerard Hopkins, François Mauriac, Robert Silhol, Warre Bradley Wells
Marching Cubes 	 006.69  	 Computer science, information & general works/Computer science, knowledge & systems/Special computer methods/Propagation-Based Marching Cubes Algorithm Using Open Boundary Loop - Marcos Sales Guerra Tsuzuki
Mechanistic Theory of Life 	 577  	 Science/Life sciences; biology/Ecology/Mechanism, Life And Personality;_ An Examination Of The Mechanistic Theory Of Life And Mind, - J. S. Haldane1860-1936  (John Scott)
Pigeonhole 	 741.5  	 Arts & recreation/Drawing & decorative arts/Drawing & drawings/Don'T Pigeonhole Me!_ Two Decades Of The Mo Willems Sketchbook - Mo Willems
Realistic Landscape 	 758.1  	 Arts & recreation/Painting/Other subjects/Studies On The Rise Of Realistic Landscape Painting In Holland, 1610-1625 - Åke Bengtsson
Why Knot 	 623.8882  	 Technology/Engineering/Military & nautical engineering/Why Knot?_ How To Tie More Than Sixty Ingenious, Useful, Beautiful, Lifesaving, And Secure Knots! - Philippe Petit
